40 40 
24 15 15 15 15 15 15 15 15 31 15 15 15 15 15 15 15 15 15 15 15 15 15 15 15 15 15 15 15 31 31 15 15 15 15 15 15 15 15 25 
14 33 33 33 33 33 33 33 33 14 32 32 32 32 32 32 32 32 32 32 32 32 32 32 32 32 32 32 32 30 28 32 32 32 32 32 32 32 32 14 
14 33 33 33 33 33 33 33 33 14 32 32 32 32 32 32 32 32 32 32 32 32 32 32 32 32 32 32 24 19 19 25 32 32 32 32 32 32 32 14 
14 33 33 33 33 33 33 33 33 14 32 32 32 32 32 32 32 32 32 32 32 32 32 32 32 32 32 24 19 36 36 19 25 32 32 32 32 32 32 14 
14 33 33 33 33 33 33 33 33 14 32 32 32 32 32 32 32 32 32 32 32 32 32 32 32 32 32 30 19 36 36 19 28 32 32 32 32 32 32 14 
14 33 33 33 33 33 33 33 24 26 32 32 32 32 32 32 32 32 32 32 32 32 32 32 32 32 32 27 19 36 36 19 26 32 32 32 32 32 32 14 
14 33 33 33 33 33 33 33 14 32 32 32 32 32 32 32 32 32 32 32 32 32 32 32 32 32 32 32 30 19 19 28 32 32 32 32 32 32 32 14 
14 33 33 33 33 33 33 33 19 19 19 32 32 32 32 32 32 32 32 32 32 32 32 32 32 32 32 32 30 19 19 28 32 32 32 32 32 32 32 14 
14 33 33 33 33 33 33 33 19 32 19 32 32 32 32 32 32 32 13 32 13 32 32 32 32 32 32 32 30 19 19 28 32 32 32 32 32 32 32 14 
14 33 33 33 33 33 33 33 19 19 19 32 32 32 32 32 32 13 32 32 32 13 32 32 32 32 24 31 19 19 19 19 31 25 32 32 32 32 32 14 
14 33 33 33 33 33 33 33 33 33 32 32 32 32 32 32 11 32 32 32 32 32 11 32 32 24 19 19 19 36 36 19 19 19 25 32 32 32 32 14 
30 15 15 15 15 15 15 19 19 19 32 32 32 32 32 32 14 32 32 32 32 32 14 32 32 30 19 36 36 36 36 36 36 19 28 32 32 32 32 14 
14 32 32 32 32 32 32 19 32 19 32 32 32 32 32 32 12 32 32 32 32 32 12 32 32 30 19 36 19 19 19 19 36 19 28 32 32 32 32 14 
14 32 9 15 15 15 15 19 19 19 32 32 32 32 32 32 32 13 32 32 32 13 32 32 32 27 19 19 19 29 29 19 19 19 26 32 32 32 32 14 
14 32 32 32 32 32 32 32 30 26 32 32 32 32 32 32 32 32 9 15 10 32 32 32 32 32 27 29 26 32 32 27 29 26 32 32 32 32 32 14 
14 32 32 32 32 13 32 32 14 32 32 32 32 32 32 32 32 32 32 32 32 24 15 10 32 32 32 32 32 32 32 32 32 32 32 32 32 32 32 14 
14 32 32 32 32 32 32 32 14 32 32 32 32 32 32 32 32 32 32 32 32 14 32 32 32 32 32 32 32 32 32 32 32 32 32 32 32 32 32 14 
14 32 32 32 32 13 32 32 14 32 32 32 32 32 32 32 32 32 32 32 32 12 32 9 25 32 32 32 32 32 32 32 32 32 32 32 32 32 32 14 
14 32 11 32 32 32 32 32 12 32 32 32 32 32 32 32 32 32 32 32 32 32 32 32 12 32 32 32 32 32 32 32 32 32 32 32 32 32 32 14 
14 32 14 32 32 13 32 32 32 32 32 32 32 32 32 32 32 32 32 32 32 32 11 32 32 9 25 32 32 32 32 32 32 32 32 32 32 32 32 14 
14 32 14 32 32 32 32 32 32 32 32 32 32 32 32 32 32 32 32 32 32 32 27 10 32 32 12 32 32 32 32 32 32 32 32 32 32 32 32 14 
14 32 27 15 15 15 15 15 10 32 32 32 32 32 32 32 32 32 32 32 32 32 32 32 11 32 32 9 25 32 32 32 32 32 32 32 32 32 32 14 
14 32 32 32 32 32 32 32 32 32 32 32 32 32 32 32 32 32 32 32 32 32 32 32 27 10 32 32 12 32 32 32 32 32 32 32 32 32 32 14 
14 32 13 32 13 32 13 32 13 32 32 32 13 32 13 32 13 32 13 32 32 32 32 32 32 32 11 32 32 32 32 32 32 32 32 32 32 32 32 14 
14 32 32 32 32 32 32 32 32 32 32 32 32 13 32 13 32 13 32 32 32 32 32 32 32 32 27 10 32 11 32 32 32 32 32 32 32 32 32 14 
14 32 32 13 32 13 32 13 32 32 32 32 13 32 32 32 32 32 13 32 32 32 32 32 32 32 32 32 32 14 32 32 32 32 32 32 32 32 32 14 
14 32 32 32 32 32 32 32 32 32 32 32 32 13 32 32 32 32 32 32 32 32 32 32 32 32 32 9 15 26 32 32 32 32 32 32 32 32 32 14 
14 32 13 32 13 32 13 32 13 32 32 32 13 32 32 32 32 32 13 32 32 32 32 24 31 25 35 35 35 35 35 35 35 35 35 35 35 35 35 14 
14 32 32 32 32 32 32 32 32 11 32 32 32 13 32 13 32 13 32 32 32 32 32 30 16 28 35 24 31 25 35 24 31 25 35 24 31 25 35 14 
14 32 32 32 32 32 32 32 32 12 32 32 13 32 13 32 13 32 13 32 32 32 32 30 16 28 35 30 16 28 35 30 16 28 35 30 16 28 35 14 
14 32 32 32 32 32 32 32 11 32 32 32 32 32 32 32 32 32 32 32 32 32 32 30 16 28 35 30 16 28 35 30 16 28 35 30 16 28 35 14 
14 32 32 32 32 32 24 15 29 15 15 15 15 15 25 32 32 32 32 32 32 32 32 30 16 16 31 16 16 16 31 16 16 16 31 16 16 16 31 28 
14 32 32 32 24 15 26 32 32 32 32 32 32 32 27 25 32 32 32 32 32 32 32 30 16 16 16 16 16 16 16 16 16 16 16 16 16 16 16 28 
14 32 24 15 26 32 32 32 32 32 24 15 15 25 32 27 25 32 32 32 32 32 32 30 16 16 18 16 16 18 16 16 16 16 16 18 16 16 18 28 
14 32 14 32 32 32 32 32 32 24 26 32 32 14 32 32 14 32 32 32 32 32 32 30 16 16 18 16 16 18 16 16 16 16 16 18 16 16 18 28 
30 31 26 32 32 32 32 32 32 14 32 32 9 26 32 32 14 32 32 32 32 32 32 30 16 16 18 16 16 18 16 16 18 16 16 18 16 16 18 28 
30 28 32 32 32 32 32 32 32 27 25 32 32 32 24 15 26 32 32 32 32 32 32 30 16 16 16 16 16 16 16 18 18 18 16 16 16 16 16 28 
30 28 32 32 32 32 32 32 32 32 27 15 15 15 26 32 32 32 32 32 32 32 32 30 16 16 16 16 16 16 16 18 18 18 16 16 16 16 16 28 
30 28 32 32 32 32 32 32 32 32 32 32 32 32 32 32 32 32 32 32 32 32 32 30 16 16 16 16 16 16 16 18 18 18 16 16 16 16 16 28 
27 29 15 15 15 15 15 15 15 15 15 15 15 15 15 15 15 15 15 15 15 15 15 29 29 29 29 29 29 29 29 29 29 29 29 29 29 29 29 26 
