25 25 
24 15 15 15 15 15 15 15 15 15 15 15 15 15 15 15 15 15 15 15 15 15 15 15 25 
14 32 32 32 32 32 32 32 32 32 32 18 32 32 32 32 32 32 32 32 32 32 32 32 14 
14 32 32 32 32 32 32 32 32 18 18 13 13 32 32 32 32 32 32 32 32 32 32 32 14 
14 32 32 32 32 32 32 32 18 18 32 32 13 32 32 32 32 32 32 32 32 32 32 32 14 
14 32 32 32 32 32 32 32 18 32 32 32 13 32 32 32 32 32 32 32 32 32 32 32 14 
14 32 32 32 32 32 32 32 18 32 32 32 13 32 32 13 13 32 32 32 32 32 32 32 14 
14 32 32 32 32 32 32 18 18 32 32 32 32 32 32 32 13 13 32 32 32 32 32 32 14 
14 32 32 18 18 18 18 18 32 32 32 17 13 13 13 32 13 13 32 32 32 32 32 32 14 
14 32 32 32 32 32 13 32 32 32 17 17 32 32 32 32 32 32 13 32 32 32 32 32 14 
14 32 32 32 32 32 13 32 32 32 17 32 32 32 32 32 32 32 13 13 32 32 32 32 14 
14 32 32 32 32 32 13 32 32 32 17 17 32 32 32 32 32 32 32 13 32 32 32 32 14 
14 32 32 32 32 32 13 32 32 32 32 17 32 32 32 32 32 32 32 13 32 32 32 32 14 
14 32 32 32 32 32 13 32 32 32 32 17 32 32 32 32 32 32 13 13 32 32 32 32 14 
14 32 32 32 32 32 32 32 32 32 32 17 32 32 32 32 32 32 13 32 32 32 32 32 14 
14 32 32 13 13 32 32 32 32 32 32 17 32 13 13 32 32 32 13 13 32 32 32 32 14 
14 32 32 32 32 32 32 32 32 32 32 17 32 32 13 13 13 32 32 32 32 32 32 32 14 
14 32 32 32 32 13 13 32 32 32 32 17 32 32 32 32 13 32 32 32 32 32 32 32 14 
14 13 13 32 32 32 13 13 32 32 32 17 17 32 32 32 19 19 19 19 19 19 19 32 14 
14 13 32 32 32 32 13 13 32 32 32 32 17 32 32 19 19 32 32 19 32 32 32 32 14 
14 13 13 13 13 13 13 32 32 32 32 17 17 32 32 19 32 32 32 32 32 32 32 32 14 
14 32 32 32 32 32 32 32 13 32 32 32 32 32 32 19 32 32 32 32 32 32 32 32 14 
14 32 32 32 32 32 32 32 13 13 32 32 32 32 32 19 32 32 32 32 32 32 32 32 14 
14 32 32 32 32 32 32 32 32 13 32 32 32 32 32 19 19 32 32 32 32 32 32 32 14 
14 32 32 32 32 32 32 32 13 32 32 32 32 32 32 19 19 32 32 32 32 32 32 32 14 
27 15 15 15 15 15 15 15 15 15 15 15 15 15 15 15 15 15 15 15 15 15 15 15 26 
